mişim	perf.nfh.ind.past.1per.sing
mişsin perf.nfh.ind.past.2per.sing
miş	perf.nfh.ind.past.3per.sinf
mişiz	perf.nfh.ind.past.1per.sing
mişsiniz	perf.nfh.ind.past.2per.plu
mişler	perf.nfh.ind.past.3per.plu
sem	perf.cnd.pres.1per.sing
sen	perf.cnd.pres.2per.sing
se	perf.cnd.pres.3per.sing
sek	perf.cnd.pres.1per.plu
seniz	perf.cnd.pres.2per.plu
seler	perf.cnd.pres.3per.plu
imdir	perf.gen.pres.1per.sing
sindir	perf.gen.pres.2per.sing
dir	perf.gen.pres.3per.sing
izdir	perf.gen.pres.1per.plu
sinizdir	perf.gen.pres.2per.plu
lerdir	perf.gen.pres.3pres.plu
dirler	perf.gen.pres.3pres.plu
im	perf.ind.pres.1per.sing
sin	perf.ind.pres.2per.sing
iz	perf.ind.pres.1per.plu
siniz	perf.ind.pres.2per.plu
dim	perf.ind.past.1per.sing
din	perf.ind.past.2per.sing
di	perf.ind.past.3per.sing
dik	perf.ind.past.1per.plu
diniz	perf.ind.past.2per.plu
diler	perf.ind.past.3per.plu
mişçesine	perf.nfh.ind.past.conv.3per.sing
ken	perf.ind.pres.conv
erken	hab.ind.pres.pos.conv.3per.sing
mezken	hab.ind.pres.neg.conv.3per.sing
lerken	hab.ind.pres.pos.conv.3per.plu
lermezken	hab.ind.pres.neg.conv.3per.plu
