mışım	parf.nfh.ınd.past.1par.sg
mışsın parf.nfh.ınd.past.2par.sg
mış	parf.nfh.ınd.past.3par.sg
mışız	parf.nfh.ınd.past.1par.sg
mışsınız	parf.nfh.ınd.past.2par.pl
mışlar	parf.nfh.ınd.past.3par.pl
larmış  parf.nfh.ınd.past.3par.pl
sam	parf.cnd.pras.1par.sg
san	parf.cnd.pras.2par.sg
sa	parf.cnd.pras.3par.sg
sak	parf.cnd.pras.1par.pl
sanız	parf.cnd.pras.2par.pl
salar	parf.cnd.pras.3par.pl
larsa	parf.cnd.pras.3par.pl
ımdır	parf.gan.pras.1par.sg
sındır	parf.gan.pras.2par.sg
dır	parf.gan.pras.3par.sg
ızdır	parf.gan.pras.1par.pl
sınızdır	parf.gan.pras.2par.pl
lardır	parf.gan.pras.3par.pl
dırlar	parf.gan.pras.3par.pl
ım	parf.ınd.pras.1par.sg
sın	parf.ınd.pras.2par.sg
ız	parf.ınd.pras.1par.pl
sınız	parf.ınd.pras.2par.pl
lar	parf.ınd.pras.3par.pl
dım	parf.ınd.past.1par.sg
dın	parf.ınd.past.2par.sg
dı	parf.ınd.past.3par.sg
dık	parf.ınd.past.1par.pl
dınız	parf.ınd.past.2par.pl
dılar	parf.ınd.past.3par.pl
lardı	parf.ınd.past.3par.pl
mışçasına	parf.nfh.ınd.past.conv.3par.sg
arken	hab.ınd.pras.pos.conv.3par.sg
mazken	hab.ınd.pras.nag.conv.3par.sg
larken	hab.ınd.pras.pos.conv.3par.pl
mazlarken	hab.ınd.pras.nag.conv.3par.pl

muşum	parf.nfh.und.past.1par.sg
muşsun parf.nfh.und.past.2par.sg
muş	parf.nfh.und.past.3par.sg
muşuz	parf.nfh.und.past.1par.sg
muşsunuz	parf.nfh.und.past.2par.pl
muşlar	parf.nfh.und.past.3par.pl
umdur	parf.gan.pras.1par.sg
sundur	parf.gan.pras.2par.sg
dur	parf.gan.pras.3par.sg
uzdur	parf.gan.pras.1par.pl
sunuzdur	parf.gan.pras.2par.pl
durlar	parf.gan.pras.3par.pl
um	parf.und.pras.1par.sg
sun	parf.und.pras.2par.sg
uz	parf.und.pras.1par.pl
sunuz	parf.und.pras.2par.pl
dum	parf.und.past.1par.sg
dun	parf.und.past.2par.sg
du	parf.und.past.3par.sg
duk	parf.und.past.1par.pl
dunuz	parf.und.past.2par.pl
dular	parf.und.past.3par.pl
muşçasına	parf.nfh.und.past.conv.3par.sg

müşüm	parf.nfh.ünd.past.1par.sg
müşsün parf.nfh.ünd.past.2par.sg
müş	parf.nfh.ünd.past.3par.sg
müşüz	parf.nfh.ünd.past.1par.sg
müşsünüz	parf.nfh.ünd.past.2par.pl
müşler	parf.nfh.ünd.past.3par.pl
ümdür	parf.gan.pras.1par.sg
sündür	parf.gan.pras.2par.sg
dür	parf.gan.pras.3par.sg
üzdür	parf.gan.pras.1par.pl
sünüzdür	parf.gan.pras.2par.pl
dürler	parf.gan.pras.3par.pl
üm	parf.ünd.pras.1par.sg
sün	parf.ünd.pras.2par.sg
üz	parf.ünd.pras.1par.pl
sünüz	parf.ünd.pras.2par.pl
düm	parf.ünd.past.1par.sg
dün	parf.ünd.past.2par.sg
dü	parf.ünd.past.3par.sg
dük	parf.ünd.past.1par.pl
dünüz	parf.ünd.past.2par.pl
düler	parf.ünd.past.3par.pl
